"filename", "language", "CMake Cache", "CMake", "comment", "blank", "total"
"/home/femu/experiment/code2/code/cmake-build-debug-remote-host/CMakeCache.txt", "CMake Cache", 332, 0, 0, 72, 404
"/home/femu/experiment/code2/code/cmake-build-debug-remote-host/CMakeFiles/3.24.0-rc1/CMakeCCompiler.cmake", "CMake", 0, 55, 0, 18, 73
"/home/femu/experiment/code2/code/cmake-build-debug-remote-host/CMakeFiles/3.24.0-rc1/CMakeCXXCompiler.cmake", "CMake", 0, 64, 0, 20, 84
"/home/femu/experiment/code2/code/cmake-build-debug-remote-host/CMakeFiles/3.24.0-rc1/CMakeSystem.cmake", "CMake", 0, 10, 0, 6, 16
"/home/femu/experiment/code2/code/cmake-build-debug-remote-host/CMakeFiles/CMakeDirectoryInformation.cmake", "CMake", 0, 12, 0, 5, 17
"/home/femu/experiment/code2/code/cmake-build-debug-remote-host/CMakeFiles/Experiment1.dir/DependInfo.cmake", "CMake", 0, 22, 0, 6, 28
"/home/femu/experiment/code2/code/cmake-build-debug-remote-host/CMakeFiles/Experiment1.dir/cmake_clean.cmake", "CMake", 0, 26, 0, 2, 28
"/home/femu/experiment/code2/code/cmake-build-debug-remote-host/CMakeFiles/Makefile.cmake", "CMake", 0, 124, 0, 6, 130
"/home/femu/experiment/code2/code/cmake-build-debug-remote-host/cmake_install.cmake", "CMake", 0, 46, 0, 9, 55
"/home/femu/experiment/code2/code/cmake-build-debug/CMakeCache.txt", "CMake Cache", 347, 0, 0, 77, 424
"/home/femu/experiment/code2/code/cmake-build-debug/CMakeFiles/3.22.3/CMakeCCompiler.cmake", "CMake", 0, 55, 0, 18, 73
"/home/femu/experiment/code2/code/cmake-build-debug/CMakeFiles/3.22.3/CMakeCXXCompiler.cmake", "CMake", 0, 64, 0, 20, 84
"/home/femu/experiment/code2/code/cmake-build-debug/CMakeFiles/3.22.3/CMakeRCCompiler.cmake", "CMake", 0, 6, 0, 1, 7
"/home/femu/experiment/code2/code/cmake-build-debug/CMakeFiles/3.22.3/CMakeSystem.cmake", "CMake", 0, 10, 0, 6, 16
"/home/femu/experiment/code2/code/cmake-build-debug/CMakeFiles/CMakeDirectoryInformation.cmake", "CMake", 0, 12, 0, 5, 17
"/home/femu/experiment/code2/code/cmake-build-debug/CMakeFiles/Experiment1.dir/DependInfo.cmake", "CMake", 0, 22, 0, 6, 28
"/home/femu/experiment/code2/code/cmake-build-debug/CMakeFiles/Experiment1.dir/cmake_clean.cmake", "CMake", 0, 28, 0, 2, 30
"/home/femu/experiment/code2/code/cmake-build-debug/CMakeFiles/Makefile.cmake", "CMake", 0, 50, 0, 6, 56
"/home/femu/experiment/code2/code/cmake-build-debug/cmake_install.cmake", "CMake", 0, 42, 0, 8, 50
"Total", "-", 679, 648, 0, 293, 1620